#############
#O----------#
#--#--------#
####--------#
#-----------#
#-----------#
#-----------#
#-----------#
#-----------#
#-----------#
#----------F#
#############
