##############################
#F-------------------#------O#
#--------------------#-------#
#--------------------#-------#
#--------------------#-------#
#--------------------#-------#
#--------------------#-------#
#--------------------#-------#
#--------------------#-------#
#--------------------#-------#
#----------------------------#
##############################
