#############
#O---#------#
#--#-#------#
####-#------#
#----#------#
#-###########
#-#---------#
#-#---------#
#-#---------#
#-###########
#----------F#
#############
