###########
#F--------#
#######---#
#---------#
#---#######
#---------#
#######---#
#---------#
#---#######
#---------#
#######-O-#
###########
